{
    "upgrade": {
      "0": "1/4",
      "1/8": "1/2",
      "1/4": "1",
      "1/2": "2",
      "1": "3",
      "2": "4",
      "3": "5",
      "4": "6",
      "5": "7",
      "6": "8",
      "7": "9",
      "8": "10",
      "9": "11",
      "10": "12",
      "11": "13",
      "12": "14",
      "13": "15",
      "14": "16",
      "15": "17",
      "16": "18",
      "17": "19",
      "18": "20",
      "19": "21",
      "20": "22",
      "21": "23",
      "22": "24",
      "23": "25",
      "24": "26",
      "25": "27",
      "26": "28",
      "27": "29",
      "28": "30",
      "29": "30",
      "30": "30"
    },
    "downgrade": {
      "0": "0",
      "1/8": "0",
      "1/4": "0",
      "1/2": "1/8",
      "1": "1/4",
      "2": "1/2",
      "3": "1",
      "4": "2",
      "5": "3",
      "6": "4",
      "7": "5",
      "8": "6",
      "9": "7",
      "10": "8",
      "11": "9",
      "12": "10",
      "13": "11",
      "14": "12",
      "15": "13",
      "16": "14",
      "17": "15",
      "18": "16",
      "19": "17",
      "20": "18",
      "21": "19",
      "22": "20",
      "23": "21",
      "24": "22",
      "25": "23",
      "26": "24",
      "27": "25",
      "28": "26",
      "29": "27",
      "30": "28"
    }
  }